111111111111111111111111111111111111111111111111111111111111111111111111111111111111111111111111111111111111111111111111111111111
100000000000000000000000000000000000000000000000000000000000000000000000000000100000000000000000000000000000000000000000000000001
100000000000000000000000000000000000000000000000000000000000000000000000000000100000000000000000000000000000000000000000000000001
100000000000000000000000000000000000000000000000000000000000000000000000000000100000000000000000000000000000000000000000000000001
100000000000000000000000000000000000000000000000000000000000000000000000000000100000000000000000000000000000000000000000000000001
100000000000000000000000000000000000000000000000000000000000000000000000000000100000000000000000000000000000000000000000000000001
100000000000000000000000000000000000000000000000000000000000000000000000000000100000000000000000000000000000000000000000000000001
100000000000000000000000000000000000000000000000000000000000000000000000000000100000000000000000000000000000000000000000000000001
100000000000000000000000000000000000000000000000000000000011111111111111111111100000000000000000000000000000000000000000000000001
10000000000000000000000000000000000000000000000000000000001P000000000000000000000000000000000000000000000000000000000000000000001
100000000000000000000000000000000000000000000000000000000010000000000000000000000000000000000000000000000000000000000000000000001
100000000000000000000000000000000000000000000000000000000010000000000000000000000000000000000000000000000000000000000000000000001
100000000000000000000000000000000000000000000000000000000011100000000000000000000000000000000000000000000000000000000000000000001
100000000000000000000000000000000000000000000000000000000010000000000000000000000000000000000000000000000000000000000000000000001
100000000000000000000000000000000000000000000000000000000000000000000000000000000000000000000000000000000000000000000000000000001
100000000000000000000000000000000000000000000000000000000010000000000000000000000000000000000000011111111111111111111111111111111
111111111111111111111111111110111111111111101111111111111111111111111111111111111111111111111111111111111111111111111111111111111
111111111111111111111111111110111111111111101111111111111111111111111111111111111111111111111111111111111111111111111111111111111
111111111111111111111111111110000000000000000000000000000011111111111111111111111111111111111111111111111111111111111111111111111
111111111111111111111111111111111111111111111111111111111111111111111111111111111111111111111111111111111111111111111111111111111
111111111111111111111111111111111111111111111111111111111111111111111111111111111111111111111111111111111111111111111111111111111
111111111111111111111111111111111111111111111111111111111111111111111111111111111111111111111111111111111111111111111111111111111
111111111111111111111111111111111111111111111111111111111111111111111111111111111111111111111111111111111111111111111111111111111
111111111111111111111111111111111111111111111111111111111111111111111111111111111111111111111111111111111111111111111111111111111
111111111111111111111111111111111111111111111111111111111111111111111111111111111111111111111111111111111111111111111111111111111
100000000000000000000000000000000000000000000000000000000010000000000000000000000000000000000000011111111111111111111111111111111
100000000000000000000000000000000000000000000000000000000010000000000000000000000000000000000000011111111111111111111111111111111
100000000000000000000000000000000000000000000000000000000010000000000000000000000000000000000000011111111111111111111111111111111
100000000000000000000000000000000000000000000000000000000010000000000000000000000000000000000000011111111111111111111111111111111
111111111111111111111111111111111111111111111111111111111111111111111111111111111111111111111111111111111111111111111111111111111

