NO textures/3d/wall.png
SO textures/3d/wall.png
WE textures/3d/wall.png
EA textures/3d/wall.png

F 220,100,0
C 225,30,0

111111111111111111111111111111111111111111111111111111111111111111111111111111111111111111111111111111111111111111111111111111111
100000000000000000000000000000000000000000000000000000000000000000000000000000100000000000000000000000000000000000000000000000001
111111000000000000000000000000000000000000000000000000000000000000000000000000100000000000000000000000000000000000000000000000001
100001000000000000000000000000000000000000000000000000000000000000000000000000100000000000000000000000000000000000000000000000001
101101000000000000000000000000000000000000000000000000000000000000000000000000100000000000000000000000000000000000000000000000001
101001000000000000000000000000000000000000000000000000000000000000000000000000100000000000000000000000000000000000000000000000001
001011000000000000000000000000000000000000000000000000000000000000000000000001000000000000000000000000000000000000000000000000001
111000000000000000000000000000000000000000000000000000000000000000000000000000100000000000000000000000000000000000000000000000001
100000000000000000000000000000000000000000000000000000000011111111111111111111100000000000000000000000000000000000000000000000001
100000000000000000000000000000000000000000000000000000000010000000000000000000000000000000000000000000000000000000000000000000001
100000000000000000000000000000000000000000000000000000000010000000000000000000000000000000000000000000000000000000000000000000001
100000000000000000000000000000000000000000000000000000000010000000000000000000000000000000000000000000000000000000000000000000001
100000000000000000000000000000000000000000000000000000000011100000000000000000000000000000000000000000000000000000000000000000001
100000000000000000000000000000000000000000000000000000000010000000000000000000000000000000000000000000000000000000000000000000001
10000000000000000000000000000000000000000P000000000000000000000000000000000000000000000000000000000000000000000000000000000000001
100000000000000000000000000000000000000000000000000000000010000000000000000000000000000000000000011111111111111111111111111111111
111111111111111111111111111110111111111111101111111111111111111111111111111111111111111111111111111111111111111111111111111111111
111111111111111111111111111110111111111111101111111111111111111111111111111111111111111111111111111111111111111111111111111111111
111111111111111111111111111110000000000000000000000000000011111111111111111111111111111111111111111111111111111111111111111111111
111111111111111111111111111111111111111111111111111111111111111111111111111111111111111111111111111111111111111111111111111111111
111111111111111111111111111111111111111111111111111111111111111111111111111111111111111111111111111111111111111111111111111111111
111111111111111111111111111111111111111111111111111111111111111111111111111111111111111111111111111111111111111111111111111111111
111111111111111111111111111111111111111111111111111111111111111111111111111111111111111111111111111111111111111111111111111111111
111111111111111111111111111111111111111111111111111111111111111111111111111111111111111111111111111111111111111111111111111111111
111111111111111111111111111111111111111111111111111111111111111111111111111111111111111111111111111111111111111111111111111111111
100000000000000000000000000000000000000000000000000000000010000000000000000000000000000000000000011111111111111111111111111111111
100000000000000000000000000000000000000000000000000000000010000000000000000000000000000000000000011111111111111111111111111111111
100000000000000000000000000000000000000000000000000000000010000000000000000000000000000000000000011111111111111111111111111111111
100000000000000000000000000000000000000000000000000000000010000000000000000000000000000000000000011111111111111111111111111111111
111111111111111111111111111111111111111111111111111111111111111111111111111111111111111111111111111111111111111111111111111111111

