NO textures/3d/wall.png
SO textures/3d/wall.png
WE textures/3d/wall.png
EA textures/3d/wall.png

F 220,100,0
C 225,30,0

1011010101010101
1010110101010101
1000000000000101
1011100101000011
0001001000010101
1010010010101001
1111111101111111
1111111101111111
1111111101111111
1111111101111111
1111111101111111
1111111101111111
1111111101111111
1111111101111111
1111111101111111
1111111101111111