1011010101010101
101P110101010101
1000000000000101
1011100101000011
0001001000010101
1010010010101001
1111111101111111
1111111101111111
11111111P1111111
1111111101111111
1111111101111111
1111111101111111
1111111101111111
1111111101111111
1111111101111111
1111111101111111